11111111111111111111111111111111111111111111111111111111111
1P0000000000000C000000000000000001000C000000000000000000001
10000000000000000000000000000000010000000000000000000000001
100000C0000000000000000000000C00010000000000000000000000001
10000000000000000000000000000000010000000000000000000000001
100000000000000C0000000000000000010000000000000C00000000001
10000000000000000000000000000000010000000000000000000000001
100C000000000000000000000000C000010000000000000000000000001
10000000000000000000000000000000010000000000000000000000001
100000000C0000000000000000000000010000000000000000000000001
10000000000000000000000000000000010000000000000000000000001
100000000000000000000C0000000000000000000000000000000000001
10000000000000000000000000000000000000000000000001111111111
10000000000000000000000000000000000000000000000000000000001
100000000000000C0000000000000000000000000000000000000000001
10000000000000000000000000000000000000000000000000000000001
10000000000000000000000000000000000000000000000000000000001
100000000000000000000C0000000000000000000000000000000000001
11111111111111000000000000000000000000000000000000000000001
1000000000000100000000000000000000000000C000000000000000001
10000000000001000000000000000000000000000000000000000000001
10000000000001000000000000000000000000000000000000000000001
100000000000010000000C000000000000000C000000000000000000001
10000000C00001000000000000000000000000000000000000000000001
10000000000001000000000000000000000000000000000000000000001
100000000000010000000000000000000000C0000000000000000000001
10000000000001000000000000000000000000000000000000000000001
100000000000010000000C0000000000000000000000000000000000001
1000000000000E000000000000000000000000000000000000000000001
11111111111111111111111111111111111111111111111111111111111