1111111111
1CCC1CCC01
1C1C1C11E1
1P1CCC1111
1111111111
