1111111111
100C000C01
10001001E1
1P000C0001
1111111111
