111111111111
100C000C01
10000000E1
1P000C0001
11111111111
1