1111111111
1P0C000C01
10000000E1
1P000C0001
1111111111