1111111111
1C100C0001
110000C0E1
1P00000001
1111111111