1111111111
1000000001
10000000E1
1P00000001
1111111111