1111111111
10000C0001
100C00C0P1
1C00000001
1111111111