1111111111
10000C0001
100C00C0P1
1C000000E1
1111111110