1111111111
1111111111
11111111E1
1P11111111
1111111111