1111111111
10000C0011
100C00C1E1
1P00000011
1111111111