1111111111
10000C0001
100C00C0E1
1P00000001
1111111111