11111111111111111111111111111111111111111111111111111111111
100000000000000C000000000000000001000C000000000000000000001
10000000000000000000000000000000010000000000000000000000001
100000C0000000000000000000000C00010000000000000000000000001
10000000000000000000000000000000010000000000000000000000001
100000000000000C0000000000000000010000000000000C00000000001
10000000000000000000000000000000010000000000000000000000001
100C000000000000000000000000C000010000000000000000000000001
10000000000000000000000000000000010000000000000000000000001
100000000C0000000000000000000000010000000000000000000000001
10000000000000000000000000000000010000000000000000000000001
100000000000000000000C0000000000000000000000000000000000001
10000000000000000000000000000000000000000000000001111111111
10000000000000000000000000000000000000000000000000000000001
100000000000000C0000000000000000000000000000000000000000001
100000000000000000000000000000000000000P0000000000000000001
10000000000000000000000000000000000000000000000000000000001
100000000000000000000C0000000000000000000000000000000000001
10000000000001000000000000000000000000000000000000000000001
100000000C000100000000000000000000000000C000000000000000001
10000000000001000000000000000000000000000000000000000000001
10000000000001000000000000000000000000000000000000000000001
100000000000010000000C000000000000000C000000000000000000001
10000000000001000000000000000000000000000000000000000000001
100000000C0001000000000000000000000000000000000000000000001
100000000000010000000000000000000000C0000000000000000000001
10000000000001000000010000000000000000000000000000000000001
100000000000010000001C1000000000000000000000000000000000011
100000000000010000000100000000000000000000000000000000001E1
11111111111111111111111111111111111111111111111111111111111
